##########..########
##########..########
##................##
##................##
....................
..#####......#####..
..#####......#####..
..#####......#####..
..###D##....##D###..
....................
....................
....................
....................
...#######.....#....
...#######..........
...#######..........
...####D##........##
......#...........##
##..............####
##..............####