##########........................######
############......................######
############................##..########
##############..............###.########
######~~######...............##.########
######.~######....##...#........########
##~.~~~.~~####....##.......##.....###.##
##~~~~~~~.######.....##....##.........##
##~~~.~~~~##########.##...............##
##~.~~~~############WWWW##WWWWWWWWWWWW##
##~~~~##############WWWW##WWWWWWWWWWWW##
##~~~~##############WWWW##WWWWWWWWWWWW##
##.~############WWWWWWWW##WWWWWWWWWWWW##
##..##########WWWWWWWWWW##WWWWWWWWWWWW##
##..##########WWWWWWWWWW##WWWWWWWWWWWW##
##..#########WWWWWWWWWWW########WWWWWW..
##.##########WWWWWWWWWWW########WWWWWW..
##.##########WWWWWWWWWWWWWWWWW##WWWWWW##
##.##S#######WWWWWWWWWWWWWWWWW##WWWWWW##
##.........##WWWWWWWWWWWWWWWWW##WWWWWW##
##.....#...##WWWWWWWWWWWWWWWWW##WWWWWW##
##...........WWWWWWWWWWWWWWWWW##WWWWWW##
##.#..................................##
##.#.............#................######
##.#..............................######
##.#............................########
##..............................########
##............##########################
##########..##...##....###....##########
########......##########################
##########SS############################
########################################
########################################
########################################
########################################
########################################
########################################
########################################
##########SS############################
WWWW######..############################
WWWW######..############################
WWWWW##~~~..~~~~#####.###.##############
WWWWWW#~~~..~~~~~.........######SS######
WWWWWW#~~~................######..######
WWWWWW##~~................#####...######
WWWWWWW#~~~~~~~~~~........#####...######
WWWWWWW####~~~~~~~~.......#####...######
WWWWWWWWWW#####............###....######
WWWWWWW##WWWWW######.......###....######
WWWWWWW##WWWWW######........←.....######
WWWWWWWWW##WWW###S###.......←.....######
WWWWWWW####W................←.....######
WWWWW####WWW................←.....######
WWWWW##WWWWWWW#.............←...########
WWWWW#WWWWWWWW##..##.....~~~←...########
WWWW###WWWWWWW######.~~~~~~~↓↓#.########
WWWW###WWWWWWWW#####~~~~~~~~~~←.########
WWWWW##WWWWWWWW#####~~~~~~~~~~↓↓↓↓######
WWWWW##WWWWWWWW######~~~~~~~~~....######
WWWWWW##WWWWWWW######~~~~~~.......######
WWWWWW##WWWWWWW#######~~~...........####
WWWWWW##WWWWWW########~~~...............
WWWWWW##WWWWWW##########................
WWWWWWW##WWWWW##########................
WWWWW####WWWWW###########...........####
WWWWW##WWWWWWW###########...........####
WWWWWW##WWWWWWW#############......######
WWWWWW##WWWWWWW############.......######
WWWWW#WWWWWWWWW############.....########
WWWW###WWWWWWWW############.....########
WWWW###WWWWWWWWW############..##########
WWWWWWW##WWWWWWW########################
WWWWWWW##WWWWWWW########################
WWWWWW##WWWWWWWWWW######################
WWWWWW##WWWWWWWWWWWW####################
WWWWW##WWWWWWWWWWWWWWWW#################
WWWWW####WWWWWWWWWWWWWWWWWWWW###########
WWWWWWW##WWWWWWWWWWWWWWWWWWWW###########
WWWWWW##WWWWWWWWWWWWWWWWWWW#############
WWWWWW##WWWWWWWWWWWWWWWWWWW##WW#########